20 
20 
178 178 178 178 178 178 178 178 178 178 178 178 178 178 178 178 178 178 178 178 
178 32 178 32 32 32 178 32 32 32 178 32 32 32 178 32 32 32 178 178 
178 32 178 32 178 32 178 32 178 32 178 32 178 32 178 32 178 32 178 178 
178 32 178 32 178 32 178 32 178 32 178 32 178 32 178 32 178 32 178 178 
178 32 178 32 178 32 178 32 178 32 178 32 178 32 178 32 178 32 178 178 
178 32 178 32 178 32 178 32 178 32 178 32 178 32 178 32 178 32 178 178 
178 32 178 32 178 32 178 32 178 32 178 32 178 32 178 32 178 32 178 178 
178 32 178 32 178 32 178 32 178 32 178 32 178 32 178 32 178 32 178 178 
178 32 178 32 178 32 178 32 178 32 178 32 178 32 178 32 178 32 178 178 
178 32 178 32 178 32 178 32 178 32 178 32 178 32 178 32 178 32 178 178 
178 32 178 32 178 32 178 32 178 32 178 32 178 32 178 32 178 32 178 178 
178 32 178 32 178 32 178 32 178 32 178 32 178 32 178 32 178 32 178 178 
178 32 178 32 178 32 178 32 178 32 178 32 178 32 178 32 178 32 178 178 
178 32 178 32 178 32 178 32 178 32 178 32 178 32 178 32 178 32 178 178 
178 32 178 32 178 32 178 32 178 32 178 32 178 32 178 32 178 32 178 178 
178 32 178 32 178 32 178 32 178 32 178 32 178 32 178 32 178 32 178 178 
178 32 178 32 178 32 178 32 178 32 178 32 178 32 178 32 178 32 178 178 
178 32 178 32 178 32 178 32 178 32 178 32 178 32 178 32 178 32 178 178 
178 32 32 32 178 32 32 32 178 32 32 32 178 32 32 32 178 32 178 178 
178 178 178 178 178 178 178 178 178 178 178 178 178 178 178 178 178 178 178 178 
